11111111111111111111111111
100P0000000G0G0G000000E001
10000000000000000000000001
10011000000000000000011001
10011000000000000000011001
10011000000000000000011001
10001100000111100000110001
10000110001100110001100001
10000011011000011011000001
10000001110000001110000001
100G000000000000000000G001
100000000CCC00CCC000000001
1000000CC000CC000CC0000001
10000000CC000000CC00000001
1000000000CCCCCC0000000001
11111111111111111111111111